BBBBBBBBBBBBBBBBBBBBBBBBBBBBBBBBBBBBBBB
B                                     B
B                                     B
B      R                              B
B     RRR                             B
B    RR RR                            B
B   RR   RR                           B
B  RR     RR                          B
B   R     R                           B
B   R     R                           B
B                                     B
B                                     B
BGGGGGGGGGGG                  G       B
BSSSSSSSSSGGG                 G       B
BSSSRRRSSSSSGGGGGGGGGGGGGGGGGGGGGGGGGGB
BSSRRRRRSSSSSSSSSSSSSSSSSSSSSSSSSSSSSSB
BRRRRRRRRRRRRRRRRRRRRRRRRRRRRRRRRRRRRRB
BBBBBBBBBBBBBBBBBBBBBBBBBBBBBBBBBBBBBBB